XXXPXXXXX
X X     X
X XXX X X
X X   X X
X X XXX X
X   X   X
XXXXX XXX
X       X
XXXXXKXXX
