XXXXXXXXXXXXXXXXXXXXXXXXXXXXXXXXXXXXXXXXXXXXXXXXXXXXXXXXXXXXXXXXX
P X     X   X   X   X       X         X     X     X             X
X X X X X XXX X X X X XXX X X XXXXXXX X X X X X X X X XXXXXXXXX X
X X X X   X   X   X X   X X X   X   X   X X X X X X X   X X     X
X X X XXXXX XXXXXXX XXX X X XXX X X XXX X XXX X XXX XXX X X XXXXX
X   X     X X       X X X X   X X X   X X     X X   X   X X     X
X XXXXXXX X X XXXXX X X X XXX X X XXX XXX XXXXX X XXX XXX XXXXX X
X X   X   X X X   X X X X X X X X   X   X X   X   X   X     X   X
X XXX X XXX X XXX X X X X X X X XXX XXX XXX X XXXXX XXXXX XXX XXX
X     X     X   X     X X X X X   X   X X   X       X     X   X X
XXXXX XXXXXXXXX XXXXXXX X X X XXXXXXX X X XXXXXXXXXXX XXXXX XXX X
X   X X       X         X X X X       X X X   X             X   X
X XXX X X X XXXXXXXXXXXXX X X X XXXXXXX X X X X XXXXXXXXXXXXX X X
X X   X X X X       X     X X   X   X   X   X X   X   X X     X X
X X XXXXX X X XXXXX X XXXXX XXXXX X X XXX XXX XXX X X X X XXXXX X
X X     X X X   X   X X X     X   X   X X   X   X   X X   X     X
X XXXXX X X XXX XXX X X X X XXX XXXXXXX XXX XXX XXXXX XXXXX XXX X
X     X X X   X   X   X   X     X         X   X     X X     X X X
X X XXX X XXXXXXX X XXXXXXXXXXX XXXXXXXXX XXX XXXXX X X XXXXX X X
X X     X   X   X X X         X     X   X         X X   X     X X
X XXXXXXXXX X X X XXX XXXXXXX XXXXX X X XXXXX XXXXX XXXXX XXXXX X
X X   X   X X X   X   X   X   X     X X X   X X   X X   X   X   X
X X X X X X X XXX X XXX X X XXXXXXX X X X X XXX X X X X X X X XXX
X X X   X   X X   X   X X   X     X   X   X     X   X X X X X   X
X X XXXXXXX X XXXXXXX X XXXXX XXX XXXXXXX XXXXX XXXXXXX X X XXX X
X X   X   X X         X       X X   X   X X   X X     X   X   X X
X XXX XXX X XXXXXXXXX XXXXXXXXX XXX X XXX X X XXX XXX X XXXXX X X
X     X   X X       X   X         X X     X X   X X X X   X   X X
XXXXX X XXXXX XXXXX XXX X X XXX XXX X XXXXX XXX X X X XXX X XXX X
X X   X       X   X   X X X X   X   X   X   X X   X X   X X X   X
X X XXXXXXXXXXX XXXXX X XXX X XXX XXXXXXX XXX XXXXX XXX XXX X XXX
X X X     X           X   X X   X       X           X   X   X X X
X X XXXXX X XXXXXXXXXXXXX X XXXXXXXXXXX XXX XXXXXXXXX XXX XXX X X
X X     X X     X     X X X       X X   X   X       X   X   X X X
X XXXXX X XXXXX X XXX X X XXXXX X X X XXX XXX XXXXX XXX X X X X X
X X       X     X   X   X     X X X X     X X X   X     X X   X X
X X XXXXXXX XXXXX X XXX XXXXX X X X XXXXXXX X X X XXXXXXX XXXXX X
X   X       X X   X   X X   X X X   X   X   X X X       X X     X
X XXX XXXXXXX X XXXXX XXX X X X XXX X X XXX X XXXXX X XXX X XXX X
X X X X X     X   X   X   X     X   X X     X     X X     X   X X
X X X X X XXX X XXX X X XXXXXXXXX XXX XXXXXXXXXXX X XXXXXXXXX X X
X X X X X X X   X   X X X X     X   X X         X X X         X X
X X X X X X XXXXX XXXXX X X XXX XXX X X XXXXXXX X X XXXXX XXXXX X
X X X X     X   X   X   X X X X X     X       X   X X     X     X
X X X XXXXX X X XXX X XXX X X X XXXXX XXXXXXX XXXXX X XXXXX XXXXX
X X X     X X X X X       X X       X X   X   X   X   X   X   X X
X X XXXXX X X X X XXXXXXXXX XXXXXXX XXX X X XXXXX XXXXX XXXXX X X
X X     X X   X X   X     X     X   X   X   X   X     X   X   X X
X X XXX X XXXXX X XXX XXX XXXXX X XXX XXXXXXX X X XXX XXX X XXX X
X X X   X X   X   X   X X       X   X X       X X   X     X X   X
X X X XXX X XXX XXX XXX XXXXXXXXXXX X XXXXX XXX X X X XXXXX X X X
X   X X X X     X   X         X     X X   X X   X X X X     X X X
XXXXX X X XXXXXXX XXX XXXXXXX X XXXXX X X X X XXXXX X X XXXXXXX X
X   X X X       X X X X     X   X     X X   X   X   X X     X   X
X XXX X XXXXXXX X X X XXXXX XXXXXXX XXX XXXXXXX X XXX XXXXX X XXX
X   X         X   X X     X         X   X     X   X   X   X X   X
X X XXXXXXX XXXXXXX XXXXX X XXXXX XXX X X XXX XXXXX XXXXX X XXX X
X X         X             X   X   X   X X X   X   X       X   X X
X XXXXXXXXXXX XXXXXXXXXXXXXXX X XXX XXXXX X XXX X X XXXXXXXXX X X
X   X       X X         X   X X X       X X     X X X       X   X
XXX X XXXXXXX XXX XXXXX X X XXX X XXXXX X XXXXXXX XXX XXX X XXX X
X X X X       X   X   X   X   X X   X   X X   X   X   X X X   X X
X X X X XXXXXXX XXX X XXXXXXX X XXX X XXX XXX X XXX XXX X XXXXX X
X     X         X   X           X   X         X         X       K
XXXXXXXXXXXXXXXXXXXXXXXXXXXXXXXXXXXXXXXXXXXXXXXXXXXXXXXXXXXXXXXXX
